M,M,M,M,M,D,D,D
P,M,M,M,D,D,D,D
P,P,M,D,D,D,D,D
W,W,W,W,D,D,D,D
P,P,P,W,W,D,D,D
P,P,P,P,W,W,D,W
P,P,P,W,W,W,W,W
P,P,W,W,W,W,W,W